15 20
00110011000011100010
00110000111000110000
00000011110000011100
00011000111100110001
00100101000001100100
01000011100010001000
00001111000010010000
00110001010101100010
10001010001110001001
10011000001000010000
11000000100001000101
11010101000011100000
00000000111111110000
11110000000111001110
11110110000101010100
13 1
1 9