5 8
00111000
00001100
00111100
10001100
00100001
1 1
1 8